XXXXXXXXXXXXXXXXXXXXXXXXXXXXXXXXXXXXXXXXXXXXXXXXXX
X                                                X
X                                                X
X     XXXXX           XXXXXXXXXXXXXXXXXXXX       X
X     XXXXX           XXXXXXXXXXXXXXXXXXXX       X
X     XXXXX           XXXXXXXXXXXXXXXXXXXX       X
X     XXXXX                                      X
X     XXXXX                                      X
X                                     XXXXXXXXXXXX
X                                     XXXXXXXXXXXX
X               X                     XXXXXXXXXXXX
X              XXX                    XXXXXXXXXXXX
X             XXXXX                   XXXXXXXXXXXX
X            XXXXXXX                  XXXXXXXXXXXX
X           XXXXXXXXX                            X
X          XXXXXXXXXXX                           X
X           XXXXXXXXX                            X
X            XXXXXXX                             X
X             XXXXX                        XX    X
X              XXX                         XX    X
X               X                          XX    X
X                                          XX    X
X                                          XX    X
X       XXXXXXXXXXXXXXXXXXXXXXXXXXXX       XX    X
X       XXXXXXXXXXXXXXXXXXXXXXXXXXXX       XX    X
X       XXXXXXXXXXXXXXXXXXXXXXXXXXXX       XX    X
X                                          XX    X
X                                                X
X                                                X
XXXXXXXXXXXXXXXXXXXXXXXXXXXXXXXXXXXXXXXXXXXXXXXXXX
